..............................................................................................................................................................................................................................................................................
..............................................................................................................................................................................................................................................................................
..............................................................................................................................................................................................................................................................................
..............................................................................................................................................................................................................................................................................
...............................................................................................................................................................Z..............................................................................................................
..............................................................................................................................................................................................................................................................................
.........................................................................SSSSSSSSSSSSSSS.............................................................BBB......................................................................................................................
........................................................................................S.....................................................................................................................................................................................
.................................................................B.......GGGGGGGGGGGG....S....................................................BBB.............................................................................................................................
.....................................................................................GG...S...................................................................................................................................................................................
...........................................................B..........................GG...S........................................BBBB.....................B................................................................................................................
............................................................................................S.................................................................................B.......ZZ....SSSSSSSSSSSSSSSSSSSSSSSSSSSSSSSSSSSSSSSSSS........................................
.....................................................B.....................................................................BBB................................................................................................................................................
.......................................................................................................................................................................B......................................................................................................
...............................S...............B.....................................................................B...................................................................B.........B.........B.........B.........B.........B..................................
...........................................................................................BB.......B.......BB...................................................B............................................................................................................
.........................................B....................................................................................................................................................................................................................................
...................................................................................................................................BB......................B.......................BB.........B.........B.........B.........B.........B.......................................
.....................ZZZZ..............ZZZZZZZZZZZZZZZZZZZZZZZZZZZZZZZZZZZZZZZZZZZZZZZZZZZZZZZZZZZZZZZZZZZZZZZZZZZZZZZZZZZZZZZZZZZZZZZZZZZZ....ZZZZ....ZZZZZZZZZZZZZZZZZZZZZZZZZZZZZZZZZZZZZZZZZZZZZZZZZZZZZZZZZZZZZZZZZZZZZZZZZZZZZZZZZZZZZZZZZZ.............................
GGGGGGGGGGGGGGGGGGGGGGGGGGGGGGGGGGGGGGGGGGGGGGGGGGGGGGGGGGGGGGGGGGGGGGGGGGGGGGGGGGGGGGGGGGGGGGGGGGGGGGGGGGGGGGGGGGGGGGGGGGGGGGGGGGGGGGGGGGGGGGGGGGGGGGGGGGGGGGGGGGGGGGGGGGGGGGGGGGGGGGGGGGGGGGGGGGGGGGGGGGGGGGGGGGGGGGGGGGGGGGGGGGGGGGGGGGGGGGGGGGGGGGGGGGGGGGGGGGGGGGGGGGGGGG