..............................................................................................................................................................................................................................................................................
..............................................................................................................................................................................................................................................................................
..............................................................................................................................................................................................................................................................................
..............................................................................................................................................................................................................................................................................
...............................................................................................................................................................Z..............................................................................................................
..............................................................................................................................................................................................................................................................................
.........................................................................LLLLLLLLLLLLLLLLL...........................................................BBB......................................................................................................................
........................................................................................LL....................................................................................................................................................................................
.................................................................B.......GGGGGGGGGGGG....L....................................................BBB.............................................................................................................................
.....................................................................................GG.......................................................................................................................................................................................
...........................................................B..........................GG............................................BBBB......................................................................................................................................
..............................................................................................................................................................................B.......ZZ....ZZ........ZZ........ZZ........ZZ........ZZ........................................
.....................................................B.....................................................................BBB................................................................................................................................................
.......................................................................................................................................................................B......................................................................................................
...............................................B.....................................................................B...................................................................B.........B.........B.........B.........B.........B..................................
...........................................................................................BB.......B.......BB...................................................B............................................................................................................
.........................................B....................................................................................................................................................................................................................................
...................................................................................................................................BB......................B.......................BB.........B.........B.........B.........B.........B.......................................
.....................ZZZZ..............ZZZZZZZZZZZZZZZZZZZZZZZZZZZZZZZZZZZZZZZZZZZZZZZZZZZZZZZZZZZZZZZZZZZZZZZZZZZZZZZZZZZZZZZZZZZZZZZZZZZZ....ZZZZ....ZZZZZZZZZZZZZZZZZZZZZZZZZZZZZZZZZZZZZZZZZZZZZZZZZZZZZZZZZZZZZZZZZZZZZZZZZZZZZZZZZZZZZZZZZZ.............................
GGGGGGGGGGGGGGGGGGGGGGGGGGGGGGGGGGGGGGGGGGGGGGGGGGGGGGGGGGGGGGGGGGGGGGGGGGGGGGGGGGGGGGGGGGGGGGGGGGGGGGGGGGGGGGGGGGGGGGGGGGGGGGGGGGGGGGGGGGGGGGGGGGGGGGGGGGGGGGGGGGGGGGGGGGGGGGGGGGGGGGGGGGGGGGGGGGGGGGGGGGGGGGGGGGGGGGGGGGGGGGGGGGGGGGGGGGGGGGGGGGGGGGGGGGGGGGGGGGGGGGGGGGGGGG