.....................................................................................
.....................................................................................
.....................#..#.#..........................................................
.....................#..#.#..........................................................
.....................#..###..........................................................
.....................................................................................
.....................................................................................
.....................................................................................
.....................................................................................
.....................................................................................
.....................................................................................
.....................................................................................
.....................................................................................
.....................................................................................
.....................................................................................
.....................................................................................
.....................................................................................
.....................................................................................
.....................................................................................
.....................................................................................
.....#...............................................................................
....##...............................................................................
...###...............#___#...........................................................
#####################################################################################