...........................................................................................................................
...........................................................................................................................
...........................................................................................................................
...........................................................................................................................
...........................................................................................................................
...........................................................................................................................
...........................................................................................................................
...........................................................................................................................
...........................................................................................................................
...........................................................................................................................
...........................................................................................................................
...........................................................................................................................
...........................................................................................................................
...........................................................................................................................
...........................................................................................................................
...........................................................................................................................
...........................................................................................................................
BBBBBBBBBBBBB..............................................................................................................
...........................................................................................................................
BBBBBBBBBBBBBBBBBBBBBBBBBBBBBBBBBBBBBBB....................................................................................
.........................BBBBBB....B..BBBBBBBBBBBBBBBBBBBBBBBBBB...........................................................
.................GLLLG...BBBBBB............................................................................................
.............B...gLLLg...BBBBBGLLLLLLLLLLLLLLG................BBBBBBBBBBBBBBBBBBBBBBBBBB...................................
GGGGGGGGGGGGGGGGGgggggGGGGGGGGggggggggggggggggGGGGGGGGGGGGGGGGGGGGGGGGGGGGGGGGGGGGGGGGGGGGGGGGGGGGGGGGGGGGGGGGGGGGGGGGGGGGG