................................................................
................................................................
................................................................
................................................................
................................................................
................................................................
................................................................
................................................................
.....................#___#......................................
################################################################