................................................................
................................................................
................................................................
................................................................
................................................................
................................................................
.....#..........................................................
....##..........................................................
...###...............#___#......................................
################################################################