........................................................................................................................................................................................................................................................
........................................................................................................................................................................................................................................................
........................................................................................................................................................................................................................................................
........................................................................................................................................................................................................................................................
........................................................................................................................................................................................................................................................
........................................................................................................................................................................................................................................................
........................................................................................................................................................................................................................................................
........................................................................................................................................................................................................................................................
........................................................................................................................................................................................................................................................
........................................................................................................................................................................................................................................................
........................................................................................................................................................................................................................................................
..............................................................B..........................................................................................................................B..............................................................
..............................................................B..........................................................................................................................B..............................................................
.............BBBBBBBBBBBBBB.................................................B.................................................................................BBBBBBB.....BBBBBBBB.....................B................................................
..............................................................B............................................................................................BLLLLLLLLB....................B..............................................................
GGGGGGGGGGGGGGGGGGGGGGGGGGGGGGGGGGGGGGGGGGGGGGGGGGGGGGGGGGGGGGGGGGGGGGGGGGGGGGGGGGGGGGGGGGGGGGGGGGGGGGGGGGGGGGGGGGGGGGGGGGGGGGGGGGGGGGGGGGGGGGGGGGGGGGGGGGGGGGGGGGGGGGGGGGGGGGGGGGGGGGGGGGGGGGGGGGGGGGGGGGGGGGGGGGGGGGGGGGGGGGGGGGGGGGGGGGGGGGGGGGGGGGGG